30 25
0 -1
10
30 26
30 27
30 28
30 29
30 30
30 31
30 32
30 33
30 34
30 35
------------------------------------------------
------------------------------------------------
X-XXXXX--XXXXXXXXXXXXXXXXXXXXXXXXXXXXXXX--XXXX-X
X-----X--X-----------------------------X--X----X
X-----X--X-----------------------------X--X----X
X-----X--X-----------------------------X--X----X
X-----X--X-----------------------------X--X----X
X-----X--X-----------------------------X--X----X
X-----X--X-----------------------------X--X----X
X----------------------------------------------X
X----------------------------------------------X
X----------------------------------------------X
X----------------------------------------------X
X---X------------------------------------------X
X---XXXXXXXXXXXXXXXXXXXXXXXXXXXXXXXXXXXX---XXXXX
X----------------------------------------------X
X----------------------------------------------X
XXXXXXXXXXXXXXXXXXXXXX---XXXXXXXXXXXXXXXXXXXXXXX
X----------------------------------------------X
X----------------------------------------------X
X----------------------------------------------X
X----------------------------------------------X
X----------------------------------------------X
X----------------------------------------------X
X----------------------------------------------X
X----------------------------------------------X
X----------------------------------------------X
X----------------------------------------------X
X----------------------------------------------X
X----------------------------------------------X
X----------------------------------------------X
X----------------------------------------------X
X----------------------------------------------X
X----------------------------------------------X
X----------------------------------------------X
X----------------------------------------------X
X----------------------------------------------X
X----------------------------------------------X
X----------------------------------------------X
X----------------------------------------------X
X----------------------------------------------X
X----------------------------------------------X
X----------------------------------------------X
X----------------------------------------------X
X----------------------------------------------X
X----------------------------------------------X
XXXXXXXXXXXXXXXXXXXXXX---XXXXXXXXXXXXXXXXXXXXXXX
X----------------------------------------------X
X----------------------------------------------X
XXXXXX---XXXXXXXXXXXXXXXXXXXXXXXXXXXXXXXXXXX---X
X------------------------------------------X---X
X----------------------------------------------X
X----------------------------------------------X
X----------------------------------------------X
X----------------------------------------------X
X--------------X--X-----X--X-------------------X
X--------------X--X-----X--X-------------------X
X--------------X--X-----X--X-------------------X
X--------------X--X-----X--X-------------------X
X--------------X--X-----X--X-------------------X
X--------------X--X-----X--X-------------------X
XXXXXXXXXXXXXXXX--XXXXXXX--XXXXXXXXXXXXXXXXXXXXX
------------------------------------------------
------------------------------------------------
