30 37
0 -1
9
30 38
30 39
30 40
30 41
30 42
30 43
30 44
30 45
30 46
XXXXXXXXXXXXXXXXXXXXXXXXXXXXXXXXXXXXXXXXXXXXXXXX
X----------------------------------------------X
X----------------------------------------------X
XX---------------------------------------------X
X---X------------------------------------------X
X------X---------------------------------------X
X---------X------------------------------------X
X------------X---------------------------------X
X---------------X------------------------------X
X------------------X---------------------------X
X---------------------X------------------------X
X------------------------X---------------------X
X---------------------------X------------------X
X------------------------------X---------------X
X---------------------------------X------------X
X------------------------------------X---------X
X---------------------------------------X------X
X------------------------------------------X---X
X---------------------------------------------XX
X------------------------------------------X---X
X---------------------------------------X------X
X------------------------------------X---------X
X---------------------------------X------------X
X------------------------------X---------------X
X---------------------------X------------------X
X------------------------X---------------------X
X---------------------X------------------------X
X------------------X---------------------------X
X---------------X------------------------------X
X------------X---------------------------------X
X---------X------------------------------------X
X------X---------------------------------------X
X---X------------------------------------------X
XX---------------------------------------------X
X---X------------------------------------------X
X------X---------------------------------------X
X---------X------------------------------------X
X------------X---------------------------------X
X---------------X------------------------------X
X------------------X---------------------------X
X---------------------X------------------------X
X------------------------X---------------------X
X---------------------------X------------------X
X------------------------------X---------------X
X---------------------------------X------------X
X------------------------------------X---------X
X---------------------------------------X------X
X------------------------------------------X---X
X---------------------------------------------XX
X------------------------------------------X---X
X---------------------------------------X------X
X------------------------------------X---------X
X---------------------------------X------------X
X------------------------------X---------------X
X---------------------------X------------------X
X------------------------X---------------------X
X---------------------X------------------------X
X------------------X---------------------------X
X---------------X------------------------------X
X------------X---------------------------------X
X---------X------------------------------------X
X------X---------------------------------------X
X---X------------------------------------------X
XXXXXXXXXXXXXXXXXXXXXXXXXXXXXXXXXXXXXXXXXXXXXXXX
