60 29
0 1
27
60 28
60 27
60 26
60 25
60 24
60 23
60 22
60 21
60 20
60 19
60 18
60 17
60 16
60 15
60 14
60 13
60 12
60 11
60 10
60 9
60 8
60 7
60 6
60 5
60 4
60 3
60 2
X---XXXXXXXXXXXXXXXXXXXXXXXXXXXXXXXXXXXXXXXXXXXX
X----------------------------------------------X
X----------------------------------------------X
X----------------------------------------------X
X----------------------------------------------X
XXXXXXXXXXXXXXXXXXXXXXXXXXXXXXXXXXXXXXXXXXXX---X
X----------------------------------------------X
X----------------------------------------------X
X----------------------------------------------X
X----------------------------------------------X
X---XXXXXXXXXXXXXXXXXXXXXXXXXXXXXXXXXXXXXXXXXXXX
X----------------------------------------------X
X----------------------------------------------X
X----------------------------------------------X
X----------------------------------------------X
XXXXXXXXXXXXXXXXXXXXXXXXXXXXXXXXXXXXXXXXXXXX---X
X----------------------------------------------X
X----------------------------------------------X
X----------------------------------------------X
X----------------------------------------------X
X---XXXXXXXXXXXXXXXXXXXXXXXXXXXXXXXXXXXXXXXXXXXX
X----------------------------------------------X
X----------------------------------------------X
X----------------------------------------------X
X----------------------------------------------X
XXXXXXXXXXXXXXXXXXXXXXXXXXXXXXXXXXXXXXXXXXXX---X
X----------------------------------------------X
X----------------------------------------------X
X----------------------------------------------X
X----------------------------------------------X
X---XXXXXXXXXXXXXXXXXXXXXXXXXXXXXXXXXXXXXXXXXXXX
X----------------------------------------------X
X----------------------------------------------X
X----------------------------------------------X
X----------------------------------------------X
XXXXXXXXXXXXXXXXXXXXXXXXXXXXXXXXXXXXXXXXXXXX---X
X----------------------------------------------X
X----------------------------------------------X
X----------------------------------------------X
X----------------------------------------------X
X---XXXXXXXXXXXXXXXXXXXXXXXXXXXXXXXXXXXXXXXXXXXX
X----------------------------------------------X
X----------------------------------------------X
X----------------------------------------------X
X----------------------------------------------X
XXXXXXXXXXXXXXXXXXXXXXXXXXXXXXXXXXXXXXXXXXXX---X
X----------------------------------------------X
X----------------------------------------------X
X----------------------------------------------X
X----------------------------------------------X
X---XXXXXXXXXXXXXXXXXXXXXXXXXXXXXXXXXXXXXXXXXXXX
X----------------------------------------------X
X----------------------------------------------X
X----------------------------------------------X
X----------------------------------------------X
XXXXXXXXXXXXXXXXXXXXXXXXXXXXXXXXXXXXXXXXXXXX---X
X----------------------------------------------X
X----------------------------------------------X
X----------------------------------------------X
X----------------------------------------------X
X----------------------------------------------X
X----------------------------------------------X
X----------------------------------------------X
X---XXXXXXXXXXXXXXXXXXXXXXXXXXXXXXXXXXXXXXXXXXXX
