7 13
1 0
5
6 13
5 13
4 13
3 13
2 13
------------------------------------------------
------------------------------------------X-----
---------------------------------------X--------
------------------------------------X-----------
---------------------------------X--X-----------
------------------------------X-----X-----------
---------------------------X--------X-----------
------------------------------X-----X-----------
---------------------------------X--X-----------
------------------------------------X-----------
---------------------------------------X--------
------------------------------------------X-----
------------------------------------------------
---------------------------XXXXXXXXXXXXXXXX-----
---------------------------X--------------------
------------------------------X-----------------
---------------------------------X--------------
------------------------------------X-----------
---------------------------------X--------------
------------------------------X-----------------
----------------------------X-------------------
---------------------------XXXXXXXXXXXXXXXX-----
------------------------------------------------
-----------------------------------XXX----------
--------------------------------XXX---XXX-------
-----------------------------XXX---------XXX----
------------------------------------------------
---------------------------XXXXXXXXXXXXXXXX-----
------------------------------------X-----------
------------------------------------X-----------
------------------------------------X-----------
---------------------------XXXXXXXXXXXXXXXX-----
------------------------------------------------
------------------------------------------X-----
---------------------------------------X--------
------------------------------------X-----------
---------------------------------X--X-----------
------------------------------X-----X-----------
---------------------------X--------X-----------
------------------------------X-----X-----------
---------------------------------X--X-----------
------------------------------------X-----------
---------------------------------------X--------
------------------------------------------X-----
------------------------------------------------
-----------------------------------XXX----------
--------------------------------XXX---XXX-------
-----------------------------XXX---------XXX----
------------------------------------------------
------------------------------------------------
------------------------------XXXXXXXXXXXX------
-----------------------------X------------X-----
-----------------------------X------------X-----
-----------------------------X------------X-----
------------------------------XXXXXXXXXXXX------
------------------------------------------------
---------------------------XXXXXXXXXXXXXXXX-----
----------------------------X-------------------
------------------------------X-----------------
---------------------------------X--------------
------------------------------------X-----------
---------------------------------------X--------
------------------------------------------X-----
---------------------------XXXXXXXXXXXXXXXX-----
