2 27
1 0
27
2 26
2 25
2 24
2 23
2 22
2 21
2 20
2 19
2 18
2 17
2 16
2 15
2 14
2 13
2 12
2 11
2 10
2 9
2 8
2 7
2 6
2 5
2 4
2 3
2 2
2 1
2 0
------------------------------------------------
------------------------------------------------
------------------------------------------------
------------------------------------------------
------------------------------------------------
XXXXXXXXXXXXXXXXXXXXXXXXXXXXXXXXXXXXXXXXXXX-----
------------------------------------------X-----
------------------------------------------X-----
------------------------------------------X-----
------------------------------------------X-----
------------------------------------------X-----
-----XXXXXXXXXXXXXXXXXXXXXXXXXXXXXXXX-----X-----
-----X------------------------------X-----X-----
-----X------------------------------X-----X-----
-----X------------------------------X-----X-----
-----X------------------------------X-----X-----
-----X------------------------------X-----X-----
-----X-----XXXXXXXXXXXXXXXXXXXX-----X-----X-----
-----X-----X------------------X-----X-----X-----
-----X-----X------------------X-----X-----X-----
-----X-----X------------------X-----X-----X-----
-----X-----X------------------X-----X-----X-----
-----X-----X------------------X-----X-----X-----
-----X-----X-----XXXXXXXX-----X-----X-----X-----
-----X-----X-----X------X-----X-----X-----X-----
-----X-----X-----X------X-----X-----X-----X-----
-----X-----X-----X------X-----X-----X-----X-----
-----X-----X-----X------X-----X-----X-----X-----
-----X-----X-----X------X-----X-----X-----X-----
-----X-----X-----X------X-----X-----X-----X-----
-----X-----X-----X------X-----X-----X-----X-----
-----X-----X-----X------X-----X-----X-----X-----
-----X-----X-----X------X-----X-----X-----X-----
-----X-----X-----X------X-----X-----X-----X-----
-----X-----X-----X------X-----X-----X-----X-----
-----X-----X-----X------X-----X-----X-----X-----
-----X-----X-----X------X-----X-----X-----X-----
-----X-----X-----X------X-----X-----X-----X-----
-----X-----X-----X------X-----X-----X-----X-----
-----X-----X-----X------X-----X-----X-----X-----
-----X-----X-----X------X-----X-----X-----X-----
-----X-----X-----X------------X-----X-----X-----
-----X-----X-----X------------X-----X-----X-----
-----X-----X-----X------------X-----X-----X-----
-----X-----X-----X------------X-----X-----X-----
-----X-----X-----X------------X-----X-----X-----
-----X-----X-----XXXXXXXXXXXXXX-----X-----X-----
-----X-----X------------------------X-----X-----
-----X-----X------------------------X-----X-----
-----X-----X------------------------X-----X-----
-----X-----X------------------------X-----X-----
-----X-----X------------------------X-----X-----
-----X-----XXXXXXXXXXXXXXXXXXXXXXXXXX-----X-----
-----X------------------------------------X-----
-----X------------------------------------X-----
-----X------------------------------------X-----
-----X------------------------------------X-----
-----X------------------------------------X-----
-----XXXXXXXXXXXXXXXXXXXXXXXXXXXXXXXXXXXXXX-----
------------------------------------------------
------------------------------------------------
------------------------------------------------
------------------------------------------------
------------------------------------------------
