29 28
1 0
26
33 27
32 27
31 27
30 27
29 27
28 27
27 27
27 29
28 28
27 28
28 29
29 29
30 29
31 29
32 29
33 29
34 29
34 27
35 27
35 29
35 28
34 28
33 28
32 28
31 28
30 28
 -----------------------------------------------
------------------------------------------------
------------------------------------------------
------------------------------------------------
----------X-------------------------------------
------X-----XXXXXXXXXXXX-X----XXX---------------
----------------------------X------XXXXXXX------
------------------------------------------X-----
------------------------------------------X-----
------------------------------------------X-----
--------------------------------X---------X-----
-------------------------------------------X----
--------------------------------X----X-----X----
-----------------------XX----------------X-X----
--------X----------XXX----XX-------------X-X----
------------------XX----------XX-X--------------
-----------------X----------------X--------X----
-----------------X-----------------X-------X----
-----------------------------------X-------X----
-----------------X------------------X-----------
------------------------------------X-----------
------------------------------------X----X-X----
-----------------X------------------X-----------
------------------------------------X------X----
------------------------------------X------X----
-----------------X----------X--------------X----
-----------------X--------XXXXX-----X------X----
--------------------------X---X-----------------
------------X-------------X---X-----X------X----
--------------------------X---X-----------------
------------------X-------X---X-----X------X----
--------------------------X---X------------X----
--------------------------X---X----X-------X----
------------------X-------X---X------------X----
--------------------------X--XX----X-------X----
--------------------------X--XX------------X----
-------------------X------XX-XX----X-------X----
------------------------------------------------
-------------------X---------------X------------
-------------------X---------------X-------X----
------------------------------------------------
-----------------------------------X-------X----
--------------------X--------------X------------
-----------------------------------X------------
----X------------------------------X-------X----
-----------------------------------X------------
------------------X-X--------------X-------X----
-----------------------------------X------------
--------------------X--------------X-------X----
------------------------------------X-----------
-------------------------------------------X----
------------------------------------X------X----
-------------------------------------X----X-----
--------------------------------------X-X-------
--------------------------------------X-X-------
------------------------------------------------
------------------------------------------------
-------------X---------------------X------------
------------------------------------------------
-------------------------X----------------------
------------------------------------------------
------------------------------------------------
------------------------------------------------
------------------------------------------------
