30 25
1 0
10
30 26
30 27
30 28
30 29
30 30
30 31
30 32
30 33
30 34
30 35
-XXXXXXXXXXXXXXXXXXXXXXXXXXXXXXXXXXXXXXXXXXXXXXX
X----------------------------------------------X
X----------------------------------------------X
X----------------------------------------------X
X----------------------------------------------X
X----------------------------------------------X
X----------------------------------------------X
X----------------------------------------------X
X----------------------------------------------X
X----------------------------------------------X
X----------------------------------------------X
X----------------------------------------------X
X----------------------------------------------X
X----------------------------------------------X
X----------------------------------------------X
X----------------------------------------------X
X----------------------------------------------X
X----------------------------------------------X
X----------------------------------------------X
X----------------------------------------------X
X----------------------------------------------X
X----------------------------------------------X
X----------------------------------------------X
X----------------------------------------------X
X----------------------------------------------X
X----------------------------------------------X
X----------------------------------------------X
X----------------------------------------------X
X----------------------------------------------X
X----------------------------------------------X
X----------------------------------------------X
X----------------------------------------------X
X----------------------------------------------X
X----------------------------------------------X
X----------------------------------------------X
X----------------------------------------------X
X----------------------------------------------X
X----------------------------------------------X
X----------------------------------------------X
X----------------------------------------------X
X----------------------------------------------X
X----------------------------------------------X
X----------------------------------------------X
X----------------------------------------------X
X----------------------------------------------X
X----------------------------------------------X
X----------------------------------------------X
X----------------------------------------------X
X----------------------------------------------X
X----------------------------------------------X
X----------------------------------------------X
X----------------------------------------------X
X----------------------------------------------X
X----------------------------------------------X
X----------------------------------------------X
X----------------------------------------------X
X----------------------------------------------X
X----------------------------------------------X
X----------------------------------------------X
X----------------------------------------------X
X----------------------------------------------X
X----------------------------------------------X
X----------------------------------------------X
XXXXXXXXXXXXXXXXXXXXXXXXXXXXXXXXXXXXXXXXXXXXXXXX
