30 25
0 -1
10
30 26
30 27
30 28
30 29
30 30
30 31
30 32
30 33
30 34
30 35
----------XXXXXXXXXXXXXXXXXXXXXXXX--------------
-----------XXXXXXXXXXXXXXXXXXXXXX---------------
------------XXXXXXXXXXXXXXXXXXXX----------------
-------------XXXXXXXXXXXXXXXXXX-----------------
--------------XXXXXXXXXXXXXXXX------------------
---------------XXXXXXXXXXXXXX-------------------
----------------XXXXXXXXXXXX--------------------
-----------------XXXXXXXXXX---------------------
------------------XXXXXXXX----------------------
-------------------XXXXXX-----------------------
X-------------------XXXX-----------------------X
XX-------------------XX-----------------------XX
XXX------------------------------------------XXX
XXXX----------------------------------------XXXX
XXXXX--------------------------------------XXXXX
XXXXXX------------------------------------XXXXXX
XXXXXXX----------------------------------XXXXXXX
XXXXXXXX--------------------------------XXXXXXXX
XXXXXXXXX------------------------------XXXXXXXXX
XXXXXXXXXX----------------------------XXXXXXXXXX
XXXXXXXXXXX--------------------------XXXXXXXXXXX
XXXXXXXXXXXX------------------------XXXXXXXXXXXX
XXXXXXXXXXXX-----------------------XXXX--------X
XXXXXXXXXXX-----------------------XXXXX-XX-XXX-X
XXXXXXXXXX-----------------------XXXXXX-XX-----X
XXXXXXXXX-------------------------XXXXX-XX-XXXXX
XXXXXXXX----------------------------XXX----XXXXX
XXXXXXX------------------------------XXXXX-----X
XXXXXX--------------------------------XXXX-XXX--
----X----------------------------------XXX------
----------------------------------------XXXXXXXX
XX---------------------------------------XXXXXXX
XX----------------------------------------XXXXXX
X----------------------XX------------------XXXXX
X----------------------XX-------------------XXXX
X---------------------XXXX-------------------XXX
X--------------------XXXXXX-------------------XX
X-------------------XXXXXXXX-------------------X
X------------------XXXXXXXXXX------------------X
X-----------------XXXXXXXXXXXX-----------------X
X----------------XXXXXXXXXXXXXX----------------X
X---------------XXXXXXXXXXXXXXXX---------------X
X--------------XXXXXXXXXXXXXXXXXX--------------X
X-------------XXXXXXXXXXXXXXXXXXXX-------------X
X------------XXXXXXXXXXXXXXXXXXXXXX------------X
X-----------XXXXXXXXXXXXXXXXXXXXXXXX-----------X
X----------XXXXXXXXXXXXXXXXXXXXXXXXXX----------X
X---------XXXXXXXXXXXXXXXXXXXXXXXXXXXX---------X
X--------XXXXXXXXXXXXXXXXXXXXXXXXXXXXXX--------X
X-------XXXXXXXXXXXXXXXXXXXXXXXXXXXXXXXX-------X
X------XXXXXXXXXXXXXXXXXXXXXXXXXXXXXXXXXX------X
X-----XXXXXXXXXXXXXXXXXXXXXXXXXXXXXXXXXXXX-----X
X----XXXXXXXXXXXXXXXXXXXXXXXXXXXXXXXXXXXXXX----X
XXXXXXXXXXXXXXXXXXXXXXXXXXXXXXXXXXXXXXXXXXXXXXXX
XXXXXXXXXXXXXXXXXXXXXXXXXXXXXXXXXXXXXXXXXXXXXXXX
XXXXXXXXXXXXXXXXXXXXXXXXXXXXXXXXXXXXXXXXXXXXXXXX
XXXXXXXXXXXXXXXXXXXXXXXXXXXXXXXXXXXXXXXXXXXXXXXX
X----------------------------------------------X
X----------------------------------------------X
X----------------------------------------------X
X----------------------------------------------X
X----------------------------------------------X
X----------------------------------------------X
------------------------------------------------
