30 25
0 -1
10
30 26
30 27
30 28
30 29
30 30
30 31
30 32
30 33
30 34
30 35
X----------------------------------------------X
X-----------------------------------------------
XXXXXXXXXXXXXXXXXX-XXXX-XXXX-XXXXXX--XXXX---XXXX
X----------------------------------------------X
X----------------------------------------------X
XXXXXXXXXXXXXXXXXX-XXXXX-XXXX-XXXXXX--XXXX--XXXX
X----------------------------------------------X
X----------------------------------------------X
X----------------------------------------------X
XXXXXXXXXXXXXXXXXX-XXXXX-XXXX-XXXXXX--XXXX--XXXX
X----------------------------------------------X
X----------------------------------------------X
XXXXXXXXXXXXXXXXXX-XXXXX-XXXX-XXXXXX--XXXX--XXXX
X----------------------------------------------X
X----------------------------------------------X
XXXX-------------------------------------------X
XXXXXXXXXXXXXXXXXX-XXXXX-XXXX-XXXXXX--XXXX--XXXX
X----------------------------------------------X
------------------------------------------------
X----------------------------------------------X
XXXXXXXXXXXXXXXXXX-XXXXX-XXXX-XXXXXX--XXXX--XXXX
-----------------------------------------------X
-----------------------------------------------X
--XXXXXXXXXXXXXXXXXXXXXXXXXXXXXXXXXXXXXXXXXXXXXX
-----------------------------------------------X
-----------------------------------------------X
XXXXXXXXXXXXXXXXXXXXXXXXXXXXXXXXXXXXXXXXXXXXX--X
X-----------------------------------------------
X-----------------------------------------------
X--XXXXXXXXXXXXXXXXXXXXXXXXXXXXXXXXXXXXXXXXXX--X
X----------------------------------------------X
X--XXXXXXXXXXXXXXXXXXXXXXXXXXXXXXXXXXXXXXXXXX--X
X----------------------------------------------X
X----------------------------------------------X
X----------------------------------------------X
XXXXXXXXXXXXXXXXXXXXXXXXXXXXXXXXXXXXXXXXXXX----X
X-----------------------------------------X----X
X-----------------------------------------X----X
X---------------XX------------------------X----X
X--------------X--------------------------X-----
--------------X---------------------------X-----
-------------X----------------------------X-----
XXXXXXXXXXXXX-----------------------------XXXXXX
X------------------------------------------XXXXX
X----------------XXXXXXXXXXXXXXXXXXXXXXXX--XXXXX
X----------------------------------------------X
X----------------------------------------------X
XXXXXXXXXXXXXXXXXXXXXXXXXXXXXXXXXXXXXXXXXX-----X
------------------------------------------------
XXXXXXXXXXXXXXXXXXXXXXXXXXXXXXXXXXXXXXXXXX-----X
X----------------------------------------------X
X----------------------------------------------X
X----------------------------------------------X
X-----------------------X---------X-X----------X
X-----XX---------------XXX-----------X---------X
X---------------------XXXXX-----------X--------X
X--------------------XXXXXXX-------------------X
X----------------------------------------------X
X--------------------XXXXXXXX-------------X----X
X----------------------------------------------X
X------------------------------------X---------X
X----------------------------------------------X
X----------------------------------------------X
XX------------XXXXXXXXXXXXXXXXXXXXXXXXXXXXXXX--X
