0 3
1 0
0
--X-X-------------------------------------------
--X-X-------------------------------------------
--X-X--XXXXXXXXXXXXXXXXX-XXXXXXXXXXXXXXXXXXXXXXX
--X-X-------------------------------------------
--X-X--XXXXXXXXXXXXXXXXX-XXXXXXXXXXXXXXXXXXXXXXX
--X-X-------------------------------------------
--X-X--XXXXXXXXXXXXXXXXX-XXXXXXXXXXXXXXXXXXXXXXX
--X-X-------------------------------------------
--X-X--XXXXXXXXXXXXXXXXX-XXXXXXXXXXXXXXXXXXXXXXX
--X-X-------------------------------------------
--X-X--XXXXXXXXXXXXXXXXX-XXXXXXXXXXXXXXXXXXXXXXX
--X-X-------------------------------------------
--X-X--XXXXXXXXXXXXXXXXX-XXXXXXXXXXXXXXXXXXXXXXX
--X-X-------------------------------------------
--X-X--XXXXXXXXXXXXXXXXX-XXXXXXXXXXXXXXXXXXXXXXX
--X-X-------------------------------------------
--X-X--XXXXXXXXXXXXXXXXX-XXXXXXXXXXXXXXXXXXXXXXX
--X-X-------------------------------------------
--X-XXXXXXXXXXXXXXXXXXXX-XXXXXXXXXXXXXXXXXXXXX--
--X-X-------------------------------------------
--X-X----------XXXXXXXXX-XXXXXXXXXXXXXXXXXXXXX--
--X-X---------X---------------------------------
--X-X--------X----------------------------------
--X-X---------------------------X---------------
--X-X------X------------------------------------
--X-X-----X------------------------------------X
--X-X-------------------------------------------
--X-X---X-----------X---------------------------
--X-XXX-----X-X-------X-------------------------
--X---------X-X---------X-----------------------
--X----X-----------------X----------------------
--X ---X------------------XX------------X----X--
----X--X-------------------------------------X--
----X-X-------------------------------X---------
----X-X-------------X---------------------X-----
--- X-X-----------------------X-----X-----------
--X---X-----------X--X----------X-------X-------
-X----X----------X---X------------X-------------
-X----X---------X----X--------------------------
-X--XX-------XX------X---------------X----------
-X--X------X---------X--------------------------
--X-X-------X-XX-XXXXX--------------------------
--X-X-------X-----------------------------------
--X-X-------X-XX-XX---------------X-------------
--X-X-------X--------X--------------------------
--X-X-------X----XXXX---------------X-----------
--X-X--------XXXX-----------------X------------X
--X-X-------------------------------------------
--X-XX------------------------------------------
--X---XXX---------------------------------------
--X----------------------------------XXXXXXX----
--X XXX--X-------------X--------------------X---
-X-------X--------------X--------------------X--
-X------XX---------------X--------------------X-
-X--XXXXXXXX--XXXXXXXXXXXXX--------------------X
-X--XXXXXXX----------------X-------------------X
--X-XXXXXX------------------X------------------X
--X-XXXXX--------------------X-----X-----------X
--X-XXXX----------------------X-----X-----------
--X-XXX------------------------X-----X----------
--X-XX--------------------------X----XX---------
--X------------------------------X---X---------X
--X-XXX---------------------------XXX----------X
------------------------------------------------
