10 23
1 0
9
9 23
8 23
7 23
6 23
5 23
4 23
3 23
2 23
1 23
XXXXXXXXXXXXXXXXXXXXXXXXXXXXXXXXXXXXXXXXXXXXXXXX
X----------------------------------------------X
X----------------------------------------------X
X----------------------------------------------X
X----------------------------------------------X
X----------------------------------------------X
X----------------------------------------------X
X----------------------------------------------X
X----------------------------------------------X
X----------------------------------------------X
X----------------------------------------------X
X----------------------------------------------X
X----------------------------------------------X
X----------------------------------------------X
X----------------------------------------------X
XXXXXXXXXXXXXXXXXXXXX-----XXXXXXXXXXXXXXXXXXXXXX
XXXXXXXXXXXXXXXXXXXXX-----XXXXXXXXXXXXXXXXXXXXXX
XXXXXXXXXXXXXXXXXXXXX-----XXXXXXXXXXXXXXXXXXXXXX
XXXXXXXXXXXXXXXXXXXXX-----XXXXXXXXXXXXXXXXXXXXXX
XXXXXXXXXXXXXXXXXXXXX-----XXXXXXXXXXXXXXXXXXXXXX
XXXXXXXXXXXXXXXXXXXXX-----XXXXXXXXXXXXXXXXXXXXXX
XXXXXXXXXXXXXXXXXXXXX-----XXXXXXXXXXXXXXXXXXXXXX
XXXXXXXXXXXXXXXXXXXXX-----XXXXXXXXXXXXXXXXXXXXXX
XXXXXXXXXXXXXXXXXXXXX-----XXXXXXXXXXXXXXXXXXXXXX
XXXXXXXXXXXXXXXXXXXXX-----XXXXXXXXXXXXXXXXXXXXXX
XXXXXXXXXXXXXXXXXXXXX-----XXXXXXXXXXXXXXXXXXXXXX
XXXXXXXXXXXXXXXXXXXXX-----XXXXXXXXXXXXXXXXXXXXXX
XXXXXXXXXXXXXXXXXXXXX-----XXXXXXXXXXXXXXXXXXXXXX
XXXXXXXXXXXXXXXXXXXXX-----XXXXXXXXXXXXXXXXXXXXXX
XXXXXXXXXXXXXXXXXXXXX-----XXXXXXXXXXXXXXXXXXXXXX
XXXXXXXXXXXXXXXXXXXXX-----XXXXXXXXXXXXXXXXXXXXXX
XXXXXXXXXXXXXXXXXXXXX-----XXXXXXXXXXXXXXXXXXXXXX
XXXXXXXXXXXXXXXXXXXXX-----XXXXXXXXXXXXXXXXXXXXXX
XXXXXXXXXXXXXXXXXXXXX-----XXXXXXXXXXXXXXXXXXXXXX
XXXXXXXXXXXXXXXXXXXXX-----XXXXXXXXXXXXXXXXXXXXXX
XXXXXXXXXXXXXXXXXXXXX-----XXXXXXXXXXXXXXXXXXXXXX
XXXXXXXXXXXXXXXXXXXXX-----XXXXXXXXXXXXXXXXXXXXXX
XXXXXXXXXXXXXXXXXXXXX-----XXXXXXXXXXXXXXXXXXXXXX
XXXXXXXXXXXXXXXXXXXXX-----XXXXXXXXXXXXXXXXXXXXXX
XXXXXXXXXXXXXXXXXXXXX-----XXXXXXXXXXXXXXXXXXXXXX
XXXXXXXXXXXXXXXXXXXXX-----XXXXXXXXXXXXXXXXXXXXXX
XXXXXXXXXXXXXXXXXXXXX-----XXXXXXXXXXXXXXXXXXXXXX
XXXXXXXXXXXXXXXXXXXXX-----XXXXXXXXXXXXXXXXXXXXXX
XXXXXXXXXXXXXXXXXXXXX-----XXXXXXXXXXXXXXXXXXXXXX
XXXXXXXXXXXXXXXXXXXXX-----XXXXXXXXXXXXXXXXXXXXXX
XXXXXXXXXXXXXXXXXXXXX-----XXXXXXXXXXXXXXXXXXXXXX
XXXXXXXXXXXXXXXXXXXXX-----XXXXXXXXXXXXXXXXXXXXXX
XXXXXXXXXXXXXXXXXXXXX-----XXXXXXXXXXXXXXXXXXXXXX
XXXXXXXXXXXXXXXXXXXXX-----XXXXXXXXXXXXXXXXXXXXXX
XXXXXXXXXXXXXXXXXXXXX-----XXXXXXXXXXXXXXXXXXXXXX
X----------------------------------------------X
X----------------------------------------------X
X----------------------------------------------X
X----------------------------------------------X
X----------------------------------------------X
X----------------------------------------------X
X----------------------------------------------X
X----------------------------------------------X
X----------------------------------------------X
X----------------------------------------------X
X----------------------------------------------X
X----------------------------------------------X
X----------------------------------------------X
XXXXXXXXXXXXXXXXXXXXXXXXXXXXXXXXXXXXXXXXXXXXXXXX
