27 25
1 0
9
26 25
25 25
24 25
23 25
22 25
21 25
20 25
19 25
18 25
XXXXXXXXXXXXXXXXXXXXXXX-----XXXXXXXXXXXXXXXXXXXX
X----------------------------------------------X
------------------------------------------------
X----------------------------------------------X
XXXXXXXXXXXXXXXXXXXXXXX-----XXXXXXXXXXXXXXXXXXXX
X----------------------------------------------X
------------------------------------------------
X----------------------------------------------X
XXXXXXXXXXXXXXXXXXXXXXX-----XXXXXXXXXXXXXXXXXXXX
X----------------------------------------------X
------------------------------------------------
X----------------------------------------------X
XXXXXXXXXXXXXXXXXXXXXXX-----XXXXXXXXXXXXXXXXXXXX
X----------------------------------------------X
------------------------------------------------
X----------------------------------------------X
XXXXXXXXXXXXXXXXXXXXXXX-----XXXXXXXXXXXXXXXXXXXX
X----------------------------------------------X
------------------------------------------------
X----------------------------------------------X
XXXXXXXXXXXXXXXXXXXXXXX-----XXXXXXXXXXXXXXXXXXXX
X----------------------------------------------X
------------------------------------------------
X----------------------------------------------X
XXXXXXXXXXXXXXXXXXXXXXX-----XXXXXXXXXXXXXXXXXXXX
X----------------------------------------------X
------------------------------------------------
X----------------------------------------------X
XXXXXXXXXXXXXXXXXXXXXXX-----XXXXXXXXXXXXXXXXXXXX
X----------------------------------------------X
------------------------------------------------
X----------------------------------------------X
XXXXXXXXXXXXXXXXXXXXXXX-----XXXXXXXXXXXXXXXXXXXX
X----------------------------------------------X
------------------------------------------------
X----------------------------------------------X
XXXXXXXXXXXXXXXXXXXXXXX-----XXXXXXXXXXXXXXXXXXXX
X----------------------------------------------X
------------------------------------------------
X----------------------------------------------X
XXXXXXXXXXXXXXXXXXXXXXX-----XXXXXXXXXXXXXXXXXXXX
X----------------------------------------------X
------------------------------------------------
X----------------------------------------------X
XXXXXXXXXXXXXXXXXXXXXXX-----XXXXXXXXXXXXXXXXXXXX
X----------------------------------------------X
------------------------------------------------
X----------------------------------------------X
XXXXXXXXXXXXXXXXXXXXXXX-----XXXXXXXXXXXXXXXXXXXX
X----------------------------------------------X
------------------------------------------------
X----------------------------------------------X
XXXXXXXXXXXXXXXXXXXXXXX-----XXXXXXXXXXXXXXXXXXXX
X----------------------------------------------X
------------------------------------------------
X----------------------------------------------X
XXXXXXXXXXXXXXXXXXXXXXX-----XXXXXXXXXXXXXXXXXXXX
X----------------------------------------------X
------------------------------------------------
X----------------------------------------------X
XXXXXXXXXXXXXXXXXXXXXXX-----XXXXXXXXXXXXXXXXXXXX
------------------------------------------------
------------------------------------------------
XXXXXXXXXXXXXXXXXXXXXXX-----XXXXXXXXXXXXXXXXXXXX
