37 24
1 0
7
36 24
35 24
34 24
33 24
32 24
31 24
30 24
XXXXXXXXXXXXXXXXXXXXXXXXXXXXXXXXXXXXXXXXXXXXXXXX
X----------------------X-----------------------X
X----------------------X--------------X--------X
X----------------------X--------------X--------X
X-----XXXXX------------X--------------X--------X
X-----X----------------X--------------X--------X
X-----X--------X-------X--------------X--------X
X-----X--------X-------X--------------XXXXX----X
X--------------X-------X-----------------------X
X--------------X-------X-----------------------X
X--------------X-------X-----------------------X
X--------------X--------------------X---XXXXXXXX
X--------------X--------------------X----------X
X--------------X--------------------X----------X
X------X------------X---------------X----------X
X------X------------X---------------X----------X
X------X-------------X--------------X----------X
X------X--------------X---------------X--------X
X------X-------------------------------X-------X
X----------------------------------------X-----X
X------------------------------------------X---X
X----------------------------------------------X
X----------------------------------------------X
X----------------------------------------------X
X----------------------------------------------X
X----------------------------------------------X
XXXXXXXXXXXXXXXXXXXXX------XXXXXXXXXXXXXXXXXXXXX
X----------------------------------------------X
X----------------------------------------------X
X----------------------------------------------X
X----------------------------------------------X
X----------------------------------------------X
X----------------------------------------------X
X----------------------------------------------X
X----------------------------------------------X
XX---------------------------------------------X
XXX--------------------------------------------X
XXXX-----------------------------------------XXX
X---X---------------------------------------XXXX
X----X-------------------------------------X---X
X-----X-----------------------------------X----X
X------X---------------------------------X-----X
X-------X-------------------------------X------X
X--------X-----------------------------X-------X
X---------X---------------------------X--------X
X----------X-------------------------X---------X
X-----------X-----------------------X----------X
X------------X---------------------X-----------X
X-------------X-------------------X------------X
X--------------X-----------------X-------------X
X---------------X---------------X--------------X
X----------------X-------------X---------------X
X-----------------X-----------X----------------X
X------------------X---------X-----------------X
X-------------------X-------X------------------X
X------X-------------X-----X-------------X-----X
X------X--------------X---X--------------X-----X
X------X------------X------X-------------X-----X
X------X-----------X--------X------------X-----X
X----XXXXX------XXX-----------XXX------XXXXX---X
X----------------------------------------------X
X----------------------------------------------X
X----------------------------------------------X
XXXXXXXXXXXXXXXXXXXXXXXXXXXXXXXXXXXXXXXXXXXXXXXX
