5 9
1 0
4
4 9
3 9
2 9
1 9
XXXXXXXXXXXXXXXXXXXXXXXXXXXXXXXXXXXXXXXX-XXXXXXX
X----------------X-----------------------------X
X----------------X-----XXXXXXXXXXXXXXXXXXXXXX--X
-----------------X-----X------------------------
X----------------X-----X----XXXXX------------X-X
X----------------X-----X-----XXX-------------X-X
X----------------X-----X------X--------------X-X
X----------------X-----X------------X--------X-X
X----------------X-----X-----------XXX-------X-X
X----------------X-----X----------XXXXX------X-X
X----------------X-----X---------XXXXXXX-----X-X
XXXXXXXXX--------X-----X---------------------X-X
X----------------X-----X-----X---------------X-X
X--------------XXX-----X----XXX--------------X-X
X---XXXXXX----XXXX-----X---XXXXX-------------X-X
X---XXXXXX----XXXX-----X--XXXXXXX------------X-X
X---XXXXXX----XXXX-----X---------XXXXXXX-----X-X
X---XXXXXX-------------X----------XXXXX------X-X
X---XXXXXX-------------X-----------XXX-------X-X
X---XXXXXX-------------X------------X--------X-X
X----------------------X---------------------X-X
X-----------XXXXXX-----X---------------X-----X-X
X-----------XXXXXX-----X--------------XXX----X-X
X-----------XXXXXX-----X-------------XXXXX---X-X
X-----------XXXXXX-----X------------XXXXXXX--X-X
------------XXXXXX-----X---XXXXXXX-----------X--
------------XXXXXX-----X----XXXXX------------X--
X----------------------X-----XXX-------------XXX
XXXXXXXXX--XXXXXXXXXX---------X----------------X
X----------------------------------------------X
X--XXXXXXXXXXXXXXXXXXXXXXXXXXXXXXXXXXXXXXXXXXX-X
X---------------XXXX-------X-----------------X-X
X---------------XXXX-------X----XXXXXXXXXXX--X-X
X---------------XXXX---X---X----X------------X-X
X---------------------XX---X----X------------X-X
X--------------------XXX--------X------------X-X
X------------------XXXXX--------X------------X-X
X-----------------X----XXXXXXXXXX-----XXXXXXXX-X
X----------------X-----X--------X-----X------X-X
X---------------X------X--------X-----X------X-X
X--------------X-------X--------X-----X------X-X
X-------------X--------X--------X-----X------X-X
X------------X---------X--------X-----X------X-X
X-----------X----------X--------X-----X------X-X
X----------X-----------X--------X-----X------X-X
X---------X------------X--------X-----X------X-X
X--------X-------------X--------X-----X------X-X
X-------X--------------X-------X------X------X-X
X------X---------------X------X--------------X-X
X-----X--X-------------X-----X--------X------X-X
X-----X--XX------------X----X---------X------X-X
X--------XXX-----------X----X---------X------X-X
X--------XXXX----------X----X---------X------X-X
X------------X---------X----X---------X------X-X
X-------------X--------X----X---------X------X-X
X--------------X-------X----X---------X------X-X
X---------------X------X----X---------X------X-X
X----------------X-----X----X---------X------X-X
X-----------------X----X----X---------X------X-X
X------------------X--------X----------------X-X
X-------------------XXXX----XXXXXXXXXXXXXXXXXX-X
--------------------XXXX------------------------
--------------------XXXX------------------------
XXXXXXXXXXXXXXXXXXXXXXXXXXXXXXXXXXXXXXXX-XXXXXXX
