31 24
1 0
0
-------------------X--------X-------------------
--------------------X------X--------------------
---------------------X----X---------------------
----------------------X--X----------------------
-----------------------XX-----------------------
-----------------------XX-----------------------
----------------------X--X----------------------
---------------------X----X---------------------
--------------------X------X--------------------
-------------------X--------X-------------------
------------------X----------X------------------
-----------------X------------X-----------------
----------------X--------------X----------------
---------------X----------------X---------------
--------------X------------------X--------------
-------------X--------------------X-------------
------------X----------------------X------------
-----------X------------------------X-----------
----------X--------------------------X----------
---------X----------------------------X---------
--------X------------------------------X--------
-------X--------------------------------X-------
------X----------------------------------X------
-----X------------------------------------X-----
----X--------------------------------------X----
---X----------------------------------------X---
--X------------------------------------------X--
-X--------------------------------------------X-
X----------------------------------------------X
XXXXXXXXXXXXXXXXXXXXXXXX-XXXXXXXXXXXXXXXXXXXXXXX
------------------------------------------------
------------------------------------------------
XXXXXXXXXXXXXXXXXXXXXXXX-XXXXXXXXXXXXXXXXXXXXXXX
-------X-------X----------------X---------X-----
--------X--------X------------------------------
------------------X------------X---------X------
-----------X------------------------------------
----X---X-----------X--------------------X------
-----------X-------------X------X---------------
--------X------X------X--X------------------X---
--XX-X------------------------------------------
-----------------X-------X-----X----------------
--------------------------------------X---------
----XX-------------X------X---------------------
------------X--------X--------------------------
----X-----------------------X----X----X-----X---
-------X--------------X-------------------------
-------------X-------XXX------------------------
-----------------------------X------X-----------
----X--------X---------------------XX-XX--------
X------------------X---X---X-XX-XX-XX--XXX-X----
--------X---------------------------------------
-------------X-------X---------X--------X-------
--X------X-----------------------X--------------
-----------X---------X------------------X-X-----
---X----------X----------X-X-----X--------------
---------X-------------------X------------------
--------------------------------------X-XX------
-------X------X------XX-----------X-------------
X---------------------------XX------------------
-----------X-------------X--------X---X-X-------
-----X------------X----------X------X-----------
------------------------------------------------
------------------------------------------------
