13 11
-1 0
4
14 11
15 11
16 11
17 11
XXXXXXXXXXXXXXXXXXXXXXXXXXXXXXXXXXXXXXXXXXXXXXXX
X----------------------------------------------X
X-----------------------X----------------------X
X-----------------------X----------------------X
X-----------------------X----------------------X
X-----------------------X----------------------X
X-----------------------X----------------------X
X-----------------------X----------------------X
X-----------------------X----------------------X
X-X---------------------X----------------------X
X--X--------------------X--------------------X-X
X---X-------------------X-------------------X--X
X----X------------------X------------------X---X
X-----X-----------------X-----------------X----X
X------X----------------X----------------X-----X
X-------X---------------X---------------X------X
X--------X--------------X--------------X-------X
X---------X-------------X-------------X--------X
X----------X------------X------------X---------X
X-----------X-----------X-----------X----------X
X------------X----------X----------X-----------X
X-------------X---------X---------X------------X
X--------------X--------X--------X-------------X
X---------------X-------X-------X--------------X
X----------------X------X------X---------------X
X-----------------X-----X-----X----------------X
X------------------X----X----X-----------------X
X-------------------X---X---X------------------X
X--------------------X--X--X-------------------X
X---------------------XXXXX--------------------X
X---------------------XXXXX--------------------X
X-XXXXXXXXXXXXXXXXXXXXXXXXXXXXXXXXXXXXXXXXXXXX-X
X---------------------XXXXX--------------------X
X---------------------XXXXX--------------------X
X--------------------X--X--X-------------------X
X-------------------X---X---X------------------X
X------------------X----X----X-----------------X
X-----------------X-----X-----X----------------X
X----------------X------X------X---------------X
X---------------X-------X-------X--------------X
X--------------X--------X--------X-------------X
X-------------X---------X---------X------------X
X------------X----------X----------X-----------X
X-----------X-----------X-----------X----------X
X----------X------------X------------X---------X
X---------X-------------X-------------X--------X
X--------X--------------X--------------X-------X
X-------X---------------X---------------X------X
X------X----------------X----------------X-----X
X-----X-----------------X-----------------X----X
X----X------------------X------------------X---X
X---X-------------------X-------------------X--X
X--X--------------------X--------------------X-X
X-X---------------------X----------------------X
X-----------------------X----------------------X
X-----------------------X----------------------X
X-----------------------X----------------------X
X-----------------------X----------------------X
X-----------------------X----------------------X
X-----------------------X----------------------X
X-----------------------X----------------------X
X-----------------------X----------------------X
X----------------------------------------------X
XXXXXXXXXXXXXXXXXXXXXXXXXXXXXXXXXXXXXXXXXXXXXXXX
