3 38
1 0
33
5 34
8 47
33 31
36 27
37 25
37 21
35 20
33 20
32 21
33 22
31 30
28 31
23 31
21 29
19 32
18 39
18 41
18 41
19 44
19 46
19 47
31 46
31 45
31 44
53 38
53 36
54 34
54 32
54 30
52 27
51 26
50 26
48 24
 -----------------------------------------------
------------------------------------------------
------------------------------------------------
------------------------------------------------
------------------------------------------------
------------------------------XXXXXX------------
--------XXXXX-----------------X------X----------
--------X----XXXXX-----------------------XXXXXXX
----X--X--------------------------------------XX
------XX--------------------------------------XX
-----XX----------------------X------------------
-----X-------------------------X----------------
-----X------------------------------------------
------------------------------------------------
----------------------XXXX-X--------------------
-------------------XXX------XX-XX---------------
------------------X-----------------------------
-----------------X------------------------------
-----------------X---------------------XXX------
-----------------X------------XXXXXXXXX---X-XXXX
---------X-------------X------------------------
-----------------X----------XX------------------
-----------------X------------------------------
------------------------------XX----------------
------------------X------------X----------------
----------------------X-------------------------
-------------------------------X----------------
------------------X-------------------------XX--
-------------------------------X------X-------X-
------------------X------------X---------X----XX
-------------------------------X----------------
------X-----------X----------XXX------------XXX-
----XXXXX---------X-------XX--------------------
----X--X----------XX-XXXX-----------------------
---X---X----------------------------------------
---X---XXX--------------------------------------
--X------X--------------------------------------
--X------X----XX--------------------------------
---------X--------X-----------------------------
--X----------X----X----X------------------------
--X------X-------XX-----------------------------
--X-------------XX---------------------X--------
--X------X--------------------------------------
---------X--------------------------------------
---------X----------------------X---------------
--X----------------X----------------------------
-----------------XX-X-X-------------------------
------------------------X------------------X----
---------X-------XX-----X------------------X----
---------X---------------X----------------------
---X----------------------X----------------X----
--------------------------X---------------X-----
------------------X--------X--------------X-----
---X--------------------------------X-X-XX------
-----------------------------X-XX-X-------------
---X--------------X-----------------------------
---X--------------------------------------------
----X------------XX-----------------------------
----XX--X--------X------------------------------
-------------XX---------------------------------
------------------------------------------------
------------------------------------------------
------------------------------------------------
------------------------------------------------
